-68
48
-41
49
000000000000000000000000000000000000000000000000000000000000000000000000000000000000000000000000000000000000000000000
111111111111111111111111111111111111111111111111111111111111111111111111111111111111111111111111111111111111111111110
111111111111111111111111111111111111111111111111111111111111111111111111111111111111111111111111111111111111111111110
111111111111111111111111111111111111111111111111111111111111111111111111111111111111111111111111111111111111111111110
111111111111111111111111111111111111111111111111111111111111111111111111111111111111111111111111111111111111111111110
111111111111111111111111111111111111111111111111111111111111111111111111111111111111111111111111111111111111111111110
111111111111111111111111111111111111111111111111111111111111111111111111111111111111111111111111111111111111111111110
111111111111111111111111111111111111111111111111111111111111111111111111111111111111111111111111111111111111111111110
111111111111111111111111111111111111111111111111111111111111111111111111111111111111111111111111111111111111111111110
111111111111111111111111111111111111111111111111111111111111111111111111111111111111111111111111111111111111111111110
111111111111111111111111111111111111111111111111111111111111111111111111111111111111111111111111111111111111111111110
111111111000000000000000000000000000000000000000000000000000000000000000000000000000000000000000000000000000011111110
111111111000000000000000000000000000000000000000000000000000000000000000000000000000000000000000000000000000011111110
111111111000000000000000000000000000000000000000000000000000000022222000000000000000000000000000000000000000011111110
111111111000000000000000000000000000000000000000000000000000000022222000000000000000000000000000000000000000011111110
111111111000000000002222200000000000000000000000000000000000000022222000000000000000000000000000000000000000011111110
111111111000000000002222200000000000000000000000000000000000000022222000000000000000000000000000000000000000011111110
111111111000000000002222200000000000000000000000000000000000000022222000000000000000000000000000000000000000011111110
111111111000000000002222200000000000000000000000000000000000000000000000000000000000000000000000000000000000011111110
111111111000000000002222200000000000000000000000000000000000000000000000000000000000000000000000000000000000011111110
111111111000000000000000000000000000000000000000000000000000000000000000000000000000000000000000000000000000011111110
111111111000000000000000000000000000000000000000000000000000000000000000000000000000000000022222000000000000011111110
111111111000000000000000000000000000000000000000000222222000000000000000000000000000000000022222000000000000011111110
111111111000000000000000000000000000000000000000000222222000000000000000022222000000000000022222000000000000011111110
111111111000000000000000000000000000000000000000000222222000000000000000022222000000000000022222000000000000011111110
111111111000000000000000000000000000000000000000000222222000000000000000022222000000000000022222000000000000011111110
111111111000000000000000000000000000000000000000000222222000000000000000022222000000000000000000000000000000011111110
111111111000000000000000000000000000000000000000000000000000000000000000022222000000000000000000000000000000011111110
111111111000000000000000000000000000000000000000000000000000000000000000000000000000000000000000000000000000011111110
111111111000000000000000222220000000000000000000000000000000000000000000000000000000000000000000000000000000011111110
111111111000000000000000222220000000000000000000000000000000000000000000000000000000000000000000000000000000011111110
111111111000000000000000222220000000000000000000000000000000000000000000000000000000000000000000000000000000011111110
111111111000000000000000222220000000000000000000000000000000000000000000000000000000000000000000000000000000011111110
111111111000000000000000222220000000000000000000000000000000000000000000000000000000002222200000000000000000011111110
111111111000000000000000000000000000000000000000000000000000000000000000000000000000002222200000000000000000011111110
111111111000000000000000000000000000000000000000000000000000000000000000000000000000002222200000000000000000011111110
111111111000000000000000000000000000000000000000000000000000000000000000000000000000002222200000000000000000011111110
111111111000000000000000000000000000000000000000000000000000000000000000000000000000002222200000000000000000011111110
111111111000000000000000000000000000000000000000000000000000000000000000000000000000000000000000000000000000011111110
111111111000000000000000000000000000000000000000000000222220000000000000000000000000000000000000000000000000011111110
111111111000000000000000000000000000000000000000000000222220000000000000000000000000000000000000000000000000011111110
111111111000000000000000000000000002222200000000000000222220000000000000000000000000000000000000000000000000011111110
111111111000000000000000000000000002222200000000000000222220000000000000000000000000000000000000000000000000011111110
111111111000002222200000000000000002222200000000000000222220000000000000000000000000000000000000000000000000011111110
111111111000002222200000000000000002222200000000000000000000000000000000000000000000000000000022222000000000011111110
111111111000002222200000000000000002222200000000000000000000000000000000000000000000000000000022222000000000011111110
111111111000002222200000000000000000000000000000000000000000000000000111111100000000000000000022222000000000011111110
111111111000002222200000000000000000000000000000000000000000000000000111111100000000000000000022222000000000011111110
111111111000000000000000000000000000000000000000000000000000000000000111111100000000000000000022222000000000011111110
111111111000000000000000000000000000000000000000000000000000000000000111111100000000000000000000000000000000011111110
111111111000000000000000000000000000000000000000000000000000000001000111111100000000000000000000000000000000011111110
111111111000000000000000000000000000000000000000000000000000000010000111011100000000000000000000000000000000011111110
111111111000000000000000000000000000000000000000000000000000000000000111011100000000000000000000000000000000011111110
111111111000000000022222000000000000000000022222000000000000000000000000000000000000000000000000000000000000011111110
111111111000000000022222000000000000000000022222000000000000000000000000000000000000000000000000000000000000011111110
111111111000000000022222000000000000000000022222000000000000000000000000000000000000000000000000000002222200011111110
111111111000000000022222000000000000000000022222000000000000000000000000000000000000000000000000000002222200011111110
111111111000000000022222000000000000000000022222000000000000000000000000000000000000000000000000000002222200011111110
111111111000000000000000000000000000000000000000000000000000000000000000000000000000000000000000000002222200011111110
111111111000000000000000000000000000000000000000000000000000000022222000000000000000000000000000000002222200011111110
111111111000000000000000000000000000000000000000000000000000000022222000000000000000000000000000000000000000011111110
111111111000000000000000000000000000000000000000000000000000000022222000000000000000000000000000000000000000011111110
111111111000000000000000000000000000000000000000000000000000000022222000000000000000000000000000000000000000011111110
111111111000000000000000000000000000000000000000000000000000000022222000000000000000000000000000000000000000011111110
111111111000000000000000000000000000000000000000000000000000000000000000000000000000000000000000000000000000011111110
111111111000000000000000000000000000000000000000000000000000000000000000000000000000000000000000000000000000011111110
111111111000000000000000000000000000000000000000000000000000000000000000000000000000000000000000000000000000011111110
111111111000000000000000000000000000000000000000000000000000000000000000000000000000000000000000000000000000011111110
111111111000000000000000000000000000000000000000000000000000000000000000000000000000000000000000000000000000011111110
111111111000000000000000000000000000000000000000000000000000000000000000000000000000000000000000000000000000011111110
111111111000000000000000000000000000000000000000000000000000000000000000000000000000000000000222220000000000011111110
111111111000000000000000000000000000000000000000000000000000000000000000000000000000000000000222220000000000011111110
111111111000000000000000000000000000000000000000000000000000000000000000000000000000000000000222220000000000011111110
111111111000000000000002222200000000000000000000000000000000000000000000000000000000000000000222220000000000011111110
111111111000000000000002222200000000000000000000000000000000000000000022222000000000000000000222220000000000011111110
111111111000000000000002222200000000000000002222200000000000000000000022222000000000000000000000000000000000011111110
111111111000000000000002222200000000000000002222200000000000000000000022222000000000000000000000000000000000011111110
111111111000000000000002222200000000000000002222200000000000000000000022222000000000000000000000000000000000011111110
111111111000000000000002222200000000000000002222200000000000000000000022222000000000000000000000000000000000011111110
111111111000000000000000000000000000000000002222200000000000000000000022222000000000000000000000000000000000011111110
111111111000000000000000000000000000000000002222200000000000000000000000000000000000000000000000000000000000011111110
111111111000000000000000000000000000000000000000000000000000000000000000000000000000000000000000000000000000011111110
111111111000000000000000000000000000000000000000000000000000000000000000000000000000000000000000000000000000011111110
111111111000000000000000000000000000000000000000000000000000000000000000000000000000000000000000000000000000011111110
111111111111111111111111111111111111111111111111111111111111111111111111111111111111111111111111111111111111111111110
111111111111111111111111111111111111111111111111111111111111111111111111111111111111111111111111111111111111111111110
111111111111111111111111111111111111111111111111111111111111111111111111111111111111111111111111111111111111111111110
111111111111111111111111111111111111111111111111111111111111111111111111111111111111111111111111111111111111111111110
111111111111111111111111111111111111111111111111111111111111111111111111111111111111111111111111111111111111111111110
111111111111111111111111111111111111111111111111111111111111111111111111111111111111111111111111111111111111111111110
111111111111111111111111111111111111111111111111111111111111111111111111111111111111111111111111111111111111111111110
