-68
47
-41
48
11111111111111111111111111111111111111111111111111111111111111111111111111111111111111111111111111111111111111111111
11111111111111111111111111111111111111111111111111111111111111111111111111111111111111111111111111111111111111111111
11111111111111111111111111111111111111111111111111111111111111111111111111111111111111111111111111111111111111111111
11111111111111111111111111111111111111111111111111111111111111111111111111111111111111111111111111111111111111111111
11111111111111111111111111111111111111111111111111111111111111111111111111111111111111111111111111111111111111111111
11111111111111111111111111111111111111111111111111111111111111111111111111111111111111111111111111111111111111111111
11111111111111111111111111111111111111111111111111111111111111111111111111111111111111111111111111111111111111111111
11111111111111111111111111111111111111111111111111111111111111111111111111111111111111111111111111111111111111111111
11111111111111111111111111111111111111111111111111111111111111111111111111111111111111111111111111111111111111111111
11111111111111111111111111111111111111111111111111111111111111111111111111111111111111111111111111111111111111111111
11111111100000000000000000000000000000000000000000000000000000000000000000000000000000000000000000000000000001111111
11111111100000000000000000000000000000000000000000000000000000000000000000000000000000000000000000000000000001111111
11111111100000000000000000000000000000000000000000000000000000002222200000000000000000000000000000000000000001111111
11111111100000000000000000000000000000000000000000000000000000002222200000000000000000000000000000000000000001111111
11111111100000000000222220000000000000000000000000000000000000002222200000000000000000000000000000000000000001111111
11111111100000000000222220000000000000000000000000000000000000002222200000000000000000000000000000000000000001111111
11111111100000000000222220000000000000000000000000000000000000002222200000000000000000000000000000000000000001111111
11111111100000000000222220000000000000000000000000000000000000000000000000000000000000000000000000000000000001111111
11111111100000000000222220000000000000000000000000000000000000000000000000000000000000000000000000000000000001111111
11111111100000000000000000000000000000000000000000000000000000000000000000000000000000000000000000000000000001111111
11111111100000000000000000000000000000000000000000000000000000000000000000000000000000000002222200000000000001111111
11111111100000000000000000000000000000000000000000022222200000000000000000000000000000000002222200000000000001111111
11111111100000000000000000000000000000000000000000022222200000000000000002222200000000000002222200000000000001111111
11111111100000000000000000000000000000000000000000022222200000000000000002222200000000000002222200000000000001111111
11111111100000000000000000000000000000000000000000022222200000000000000002222200000000000002222200000000000001111111
11111111100000000000000000000000000000000000000000022222200000000000000002222200000000000000000000000000000001111111
11111111100000000000000000000000000000000000000000000000000000000000000002222200000000000000000000000000000001111111
11111111100000000000000000000000000000000000000000000000000000000000000000000000000000000000000000000000000001111111
11111111100000000000000022222000000000000000000000000000000000000000000000000000000000000000000000000000000001111111
11111111100000000000000022222000000000000000000000000000000000000000000000000000000000000000000000000000000001111111
11111111100000000000000022222000000000000000000000000000000000000000000000000000000000000000000000000000000001111111
11111111100000000000000022222000000000000000000000000000000000000000000000000000000000000000000000000000000001111111
11111111100000000000000022222000000000000000000000000000000000000000000000000000000000222220000000000000000001111111
11111111100000000000000000000000000000000000000000000000000000000000000000000000000000222220000000000000000001111111
11111111100000000000000000000000000000000000000000000000000000000000000000000000000000222220000000000000000001111111
11111111100000000000000000000000000000000000000000000000000000000000000000000000000000222220000000000000000001111111
11111111100000000000000000000000000000000000000000000000000000000000000000000000000000222220000000000000000001111111
11111111100000000000000000000000000000000000000000000000000000000000000000000000000000000000000000000000000001111111
11111111100000000000000000000000000000000000000000000022222000000000000000000000000000000000000000000000000001111111
11111111100000000000000000000000000000000000000000000022222000000000000000000000000000000000000000000000000001111111
11111111100000000000000000000000000222220000000000000022222000000000000000000000000000000000000000000000000001111111
11111111100000000000000000000000000222220000000000000022222000000000000000000000000000000000000000000000000001111111
11111111100000222220000000000000000222220000000000000022222000000000000000000000000000000000000000000000000001111111
11111111100000222220000000000000000222220000000000000000000000000000000000000000000000000000002222200000000001111111
11111111100000222220000000000000000222220000000000000000000000000000000000000000000000000000002222200000000001111111
11111111100000222220000000000000000000000000000000000000000000000000011111110000000000000000002222200000000001111111
11111111100000222220000000000000000000000000000000000000000000000000011111110000000000000000002222200000000001111111
11111111100000000000000000000000000000000000000000000000000000000000011111110000000000000000002222200000000001111111
11111111100000000000000000000000000000000000000000000000000000000000011111110000000000000000000000000000000001111111
11111111100000000000000000000000000000000000000000000000000000000100011111110000000000000000000000000000000001111111
11111111100000000000000000000000000000000000000000000000000000001000011101110000000000000000000000000000000001111111
11111111100000000000000000000000000000000000000000000000000000000000011101110000000000000000000000000000000001111111
11111111100000000002222200000000000000000002222200000000000000000000000000000000000000000000000000000000000001111111
11111111100000000002222200000000000000000002222200000000000000000000000000000000000000000000000000000000000001111111
11111111100000000002222200000000000000000002222200000000000000000000000000000000000000000000000000000222220001111111
11111111100000000002222200000000000000000002222200000000000000000000000000000000000000000000000000000222220001111111
11111111100000000002222200000000000000000002222200000000000000000000000000000000000000000000000000000222220001111111
11111111100000000000000000000000000000000000000000000000000000000000000000000000000000000000000000000222220001111111
11111111100000000000000000000000000000000000000000000000000000002222200000000000000000000000000000000222220001111111
11111111100000000000000000000000000000000000000000000000000000002222200000000000000000000000000000000000000001111111
11111111100000000000000000000000000000000000000000000000000000002222200000000000000000000000000000000000000001111111
11111111100000000000000000000000000000000000000000000000000000002222200000000000000000000000000000000000000001111111
11111111100000000000000000000000000000000000000000000000000000002222200000000000000000000000000000000000000001111111
11111111100000000000000000000000000000000000000000000000000000000000000000000000000000000000000000000000000001111111
11111111100000000000000000000000000000000000000000000000000000000000000000000000000000000000000000000000000001111111
11111111100000000000000000000000000000000000000000000000000000000000000000000000000000000000000000000000000001111111
11111111100000000000000000000000000000000000000000000000000000000000000000000000000000000000000000000000000001111111
11111111100000000000000000000000000000000000000000000000000000000000000000000000000000000000000000000000000001111111
11111111100000000000000000000000000000000000000000000000000000000000000000000000000000000000000000000000000001111111
11111111100000000000000000000000000000000000000000000000000000000000000000000000000000000000022222000000000001111111
11111111100000000000000000000000000000000000000000000000000000000000000000000000000000000000022222000000000001111111
11111111100000000000000000000000000000000000000000000000000000000000000000000000000000000000022222000000000001111111
11111111100000000000000222220000000000000000000000000000000000000000000000000000000000000000022222000000000001111111
11111111100000000000000222220000000000000000000000000000000000000000002222200000000000000000022222000000000001111111
11111111100000000000000222220000000000000000222220000000000000000000002222200000000000000000000000000000000001111111
11111111100000000000000222220000000000000000222220000000000000000000002222200000000000000000000000000000000001111111
11111111100000000000000222220000000000000000222220000000000000000000002222200000000000000000000000000000000001111111
11111111100000000000000222220000000000000000222220000000000000000000002222200000000000000000000000000000000001111111
11111111100000000000000000000000000000000000222220000000000000000000002222200000000000000000000000000000000001111111
11111111100000000000000000000000000000000000222220000000000000000000000000000000000000000000000000000000000001111111
11111111100000000000000000000000000000000000000000000000000000000000000000000000000000000000000000000000000001111111
11111111100000000000000000000000000000000000000000000000000000000000000000000000000000000000000000000000000001111111
11111111100000000000000000000000000000000000000000000000000000000000000000000000000000000000000000000000000001111111
11111111111111111111111111111111111111111111111111111111111111111111111111111111111111111111111111111111111111111111
11111111111111111111111111111111111111111111111111111111111111111111111111111111111111111111111111111111111111111111
11111111111111111111111111111111111111111111111111111111111111111111111111111111111111111111111111111111111111111111
11111111111111111111111111111111111111111111111111111111111111111111111111111111111111111111111111111111111111111111
11111111111111111111111111111111111111111111111111111111111111111111111111111111111111111111111111111111111111111111
11111111111111111111111111111111111111111111111111111111111111111111111111111111111111111111111111111111111111111111
11111111111111111111111111111111111111111111111111111111111111111111111111111111111111111111111111111111111111111111
