000000000000000000000000000000000000000000000000000000000000000000000000000000000000000000000000000000000000000000000
111111111111111111111111111111111111111111111111111111111111111111111111111111111111111111111111111111111111111111110
111111111111111111111111111111111111111111111111111111111111111111111111111111111111111111111111111111111111111111110
111111111111111111111111111111111111111111111111111111111111111111111111111111111111111111111111111111111111111111110
111111111111111111111111111111111111111111111111111111111111111111111111111111111111111111111111111111111111111111110
111111111111111111111111111111111111111111111111111111111111111111111111111111111111111111111111111111111111111111110
111111111111111111111111111111111111111111111111111111111111111111111111111111111111111111111111111111111111111111110
111111111111111111111111111111111111111111111111111111111111111111111111111111111111111111111111111111111111111111110
111111111111111111111111111111111111111111111111111111111111111111111111111111111111111111111111111111111111111111110
111111111111111111111111111111111111111111111111111111111111111111111111111111111111111111111111111111111111111111110
111111111111111111111111111111111111111111111111111111111111111111111111111111111111111111111111111111111111111111110
111111111000000000000000000000000000000000000000000000000000000000000000000000000000000000000000000000000000011111110
111111111000000000000000000000000000000000000000000000000000000000000000000000000000000000000000000000000000011111110
111111111000000000000000000000000000000000000000000000000000000000000000000000000000000000000000000000000000011111110
111111111000000000000000000000000000000000000000000000000000000000000000000000000000000000000000000000000000011111110
111111111000000000000000000000000000000000000000000000000000000000000000000000000000000000000000000000000000011111110
111111111000000000000000000000000000000000000000000000000000000000000000000000000000000000000000000000000000011111110
111111111000000000000000000000000000000000000000000000000000000000000000000000000000000000000000000000000000011111110
111111111000000000000000000000000000000000000000000000000000000000000000000000000000000000000000000000000000011111110
111111111000000000000000000000000000000000000000000000000000000000000000000000000000000000000000000000000000011111110
111111111000000000000000000000000000000000000000000000000000000000000000000000000000000000000000000000000000011111110
111111111000000000000000000000000000000000000000000000000000000000000000000000000000000000000000000000000000011111110
111111111000000000000000000000000000000000000000000000000000000000000000000000000000000000000000000000000000011111110
111111111000000000000000000000000000000000000000000000000000000000000000000000000000000000000000000000000000011111110
111111111000000000000000000000000000000000000000000000000000000000000000000000000000000000000000000000000000011111110
111111111000000000000000000000000000000000000000000000000000000000000000000000000000000000000000000000000000011111110
111111111000000000000000000000000000000000000000000000000000000000000000000000000000000000000000000000000000011111110
111111111000000000000000000000000000000000000000000000000000000000000000000000000000000000000000000000000000011111110
111111111000000000000000000000000000000000000000000000000000000000000000000000000000000000000000000000000000011111110
111111111000000000000000000000000000000000000000000000000000000000000000000000000000000000000000000000000000011111110
111111111000000000000000000000000000000000000000000000000000000000000000000000000000000000000000000000000000011111110
111111111000000000000000000000000000000000000000000000000000000000000000000000000000000000000000000000000000011111110
111111111000000000000000000000000000000000000000000000000000000000000000000000000000000000000000000000000000011111110
111111111000000000000000000000000000000000000000000000000000000000000000000000000000000000000000000000000000011111110
111111111000000000000000000000000000000000000000000000000000000000000000000000000000000000000000000000000000011111110
111111111000000000000000000000000000000000000000000000000000000000000000000000000000000000000000000000000000011111110
111111111000000000000000000000000000000000000000000000000000000000000000000000000000000000000000000000000000011111110
111111111000000000000000000000000000000000000000000000000000000000000000000000000000000000000000000000000000011111110
111111111000000000000000000000000000000000000000000000000000000000000000000000000000000000000000000000000000011111110
111111111000000000000000000000000000000000000000000000000000000000000000000000000000000000000000000000000000011111110
111111111000000000000000000000000000000000000000000000000000000000000000000000000000000000000000000000000000011111110
111111111000000000000000000000000000000000000000000000000000000000000000000000000000000000000000000000000000011111110
111111111000000000000000000000000000000000000000000000000000000000000000000000000000000000000000000000000000011111110
111111111000000000000000000000000000000000000000000000000000000000000000000000000000000000000000000000000000011111110
111111111000000000000000000000000000000000000000000000000000000000000000000000000000000000000000000000000000011111110
111111111000000000000000000000000000000000000000000000000000000000000000000000000000000000000000000000000000011111110
111111111000000000000000000000000000000000000000000000000000000000000111111100000000000000000000000000000000011111110
111111111000000000000000000000000000000000000000000000000000000000000111111100000000000000000000000000000000011111110
111111111000000000000000000000000000000000000000000000000000000000000111111100000000000000000000000000000000011111110
111111111000000000000000000000000000000000000000000000000000000000000111111100000000000000000000000000000000011111110
111111111000000000000000000000000000000000000000000000000000000001000111111100000000000000000000000000000000011111110
111111111000000000000000000000000000000000000000000000000000000010000111011100000000000000000000000000000000011111110
111111111000000000000000000000000000000000000000000000000000000000000111011100000000000000000000000000000000011111110
111111111000000000000000000000000000000000000000000000000000000000000000000000000000000000000000000000000000011111110
111111111000000000000000000000000000000000000000000000000000000000000000000000000000000000000000000000000000011111110
111111111000000000000000000000000000000000000000000000000000000000000000000000000000000000000000000000000000011111110
111111111000000000000000000000000000000000000000000000000000000000000000000000000000000000000000000000000000011111110
111111111000000000000000000000000000000000000000000000000000000000000000000000000000000000000000000000000000011111110
111111111000000000000000000000000000000000000000000000000000000000000000000000000000000000000000000000000000011111110
111111111000000000000000000000000000000000000000000000000000000000000000000000000000000000000000000000000000011111110
111111111000000000000000000000000000000000000000000000000000000000000000000000000000000000000000000000000000011111110
111111111000000000000000000000000000000000000000000000000000000000000000000000000000000000000000000000000000011111110
111111111000000000000000000000000000000000000000000000000000000000000000000000000000000000000000000000000000011111110
111111111000000000000000000000000000000000000000000000000000000000000000000000000000000000000000000000000000011111110
111111111000000000000000000000000000000000000000000000000000000000000000000000000000000000000000000000000000011111110
111111111000000000000000000000000000000000000000000000000000000000000000000000000000000000000000000000000000011111110
111111111000000000000000000000000000000000000000000000000000000000000000000000000000000000000000000000000000011111110
111111111000000000000000000000000000000000000000000000000000000000000000000000000000000000000000000000000000011111110
111111111000000000000000000000000000000000000000000000000000000000000000000000000000000000000000000000000000011111110
111111111000000000000000000000000000000000000000000000000000000000000000000000000000000000000000000000000000011111110
111111111000000000000000000000000000000000000000000000000000000000000000000000000000000000000000000000000000011111110
111111111000000000000000000000000000000000000000000000000000000000000000000000000000000000000000000000000000011111110
111111111000000000000000000000000000000000000000000000000000000000000000000000000000000000000000000000000000011111110
111111111000000000000000000000000000000000000000000000000000000000000000000000000000000000000000000000000000011111110
111111111000000000000000000000000000000000000000000000000000000000000000000000000000000000000000000000000000011111110
111111111000000000000000000000000000000000000000000000000000000000000000000000000000000000000000000000000000011111110
111111111000000000000000000000000000000000000000000000000000000000000000000000000000000000000000000000000000011111110
111111111000000000000000000000000000000000000000000000000000000000000000000000000000000000000000000000000000011111110
111111111000000000000000000000000000000000000000000000000000000000000000000000000000000000000000000000000000011111110
111111111000000000000000000000000000000000000000000000000000000000000000000000000000000000000000000000000000011111110
111111111000000000000000000000000000000000000000000000000000000000000000000000000000000000000000000000000000011111110
111111111000000000000000000000000000000000000000000000000000000000000000000000000000000000000000000000000000011111110
111111111000000000000000000000000000000000000000000000000000000000000000000000000000000000000000000000000000011111110
111111111000000000000000000000000000000000000000000000000000000000000000000000000000000000000000000000000000011111110
111111111111111111111111111111111111111111111111111111111111111111111111111111111111111111111111111111111111111111110
111111111111111111111111111111111111111111111111111111111111111111111111111111111111111111111111111111111111111111110
111111111111111111111111111111111111111111111111111111111111111111111111111111111111111111111111111111111111111111110
111111111111111111111111111111111111111111111111111111111111111111111111111111111111111111111111111111111111111111110
111111111111111111111111111111111111111111111111111111111111111111111111111111111111111111111111111111111111111111110
111111111111111111111111111111111111111111111111111111111111111111111111111111111111111111111111111111111111111111110
