-24
30
-19
17
1111111111111111111111111111111111111111111111111111111
1111111111111111111111111111111111111111111111111111111
1110000000000000000000000000000000000000000000000000011
1110000000000000000000000000000000000000000000000000011
1110000010000000000000000000000000000000000000000000011
1110000000000000000000000000000001000000000000000000011
1110000000000000000000000000000000000000000000100000011
1110000000000000000010000000000000000000000000000000011
1110000000000000000000000000000000000000000000000000011
1110000000000000000000000000000000000000000000000000011
1110000001000000000000000000000000000000000000000000011
1110000000000000000000000000000000001000000000000000011
1110000000000000000000000000000000000000000000001000011
1110000000000000000000000000000000000000000000000000011
1110000000000000000100000000000000000000000000000000011
1110000000000000000000000000011000000000000000000000011
1110000000000000000000000000000000000000000000000000011
1110000000000000000000000000000000001000000000000000011
1110000000000000000000000000000000000000000000000000011
1110000000000000000000000000000000000000000000000000011
1110000000000000100000000000000000000000000000000000011
1110000000000000000000000000000000000000000000000000011
1110000100000000000000000000000000000000000000000000011
1110000000000000000000000000000000000000000000001000011
1110000000000000000000000000000000000000000000000000011
1110000000000010000000000000000000000000000000000000011
1110000000000000000000000000000000000000001000000000011
1110000000000000000000000000000000000000000000000000011
1110000000000000000000000000000000000000000000000000011
1110000000000000000000000000000000000000000000000000011
1110000000000000000000000000000000000000000000000000011
1110000000000000000000000000000000000000000000000000011
1110000000000000000000000001000000000000000000000010011
1110000000000000000000000000000000000000000000000000011
1110000000000000000000000000000000000000000000000000011
1111111111111111111111111111111111111111111111111111111
1111111111111111111111111111111111111111111111111111111
