-32
49
-17
15
1111111111111111111111111111111111111111111111111111111111111111111111111111111111
1111111111111111111111111111111111111111111111111111111111111111111111111111111111
1111111111111111111111111111111111111111111111111111111111111111111111111111111111
1111111111111111111111111111111111111111111111111111111111111111111111111111111111
1111111111000000000000000000000000000000000000000000000000000001111111111111111111
1111111111000000000000000000000000000000000000000000000000000001111111111111111111
1111111111000000000000000000000000000000000000000000000000000001111111111111111111
1111111111000000000000000000000000000000000000000000000000000001111111111111111111
1111111111000000000000000000000000000000000000000000000000000001111111111111111111
1111111111000000000000000000000000000000000000000000000000000001111111111111111111
1111111111000000000000000000000000000000000000000000000000000001111111111111111111
1111111111000000000000000000000000000000000000000000000000000001111111111111111111
1333333333000000000000000000000000000000000000000000000000000001111111111111111111
1333333333000000000000000000000000000000000000000000000000000004444444444441111111
1333333333000000000000000000000000000000000000000000000000000004444444444441111111
1333333333000000000000000000000000000000000000000000000000000004444444444441111111
1333333333000000000000000000000000000000000000000000000000000004444444444441111111
1333333333000000000000000000000000000000000000000000000000000004444444444441111111
1333333333000000000000000000000000000000000000000000000000000001111111111111111111
1333333333000000000000000000000000000000000000000000000000000001111111111111111111
1111111111000000000000000000000000000000000000000000000000000001111111111111111111
1111111111000000000000000000000000000000000000000000000000000001111111111111111111
1111111111000000000000000000000000000000000000000000000000000001111111111111111111
1111111111000000000000000000000000000000000000000000000000000001111111111111111111
1111111111000000000000000000000000000000000000000000000000000001111111111111111111
1111111111000000000000000000000000000000000000000000000000000001111111111111111111
1111111111000000000000000000000000000000000000000000000000000001111111111111111111
1111111111000000000000000000000000000000000000000000000000000001111111111111111111
1111111111000000000000000000000000000000000000000000000000000001111111111111111111
1111111111000000000000000000000000000000000000000000000000000001111111111111111111
1111111111111111111111111111111111111111111111111111111111111111111111111111111111
1111111111111111111111111111111111111111111111111111111111111111111111111111111111
1111111111111111111111111111111111111111111111111111111111111111111111111111111111
