-24
49
-17
15
11111111111111111111111111111111111111111111111111111111111111111111111111
11111111111111111111111111111111111111111111111111111111111111111111111111
11111111111111111111111111111111111111111111111111111111111111111111111111
11111111111111111111111111111111111111111111111111111111111111111111111111
11000000000000000000000000000000000000000000000000000001111111111111111111
11000000000000000000000000000000000000000000000000000001111111111111111111
11000000000000000000000000000000000000000000000000000001111111111111111111
11000000000000000000000000000000000000000000000000000001111111111111111111
11000000000000000000000000000000000000000000000000000001111111111111111111
11000000000000000000000000000000000000000000000000000001111111111111111111
11000000000000000000000000000000000000000000000000000001111111111111111111
11000000000000000000000000000000000000000000000000000001111111111111111111
11000000000000000000000001111111000000000000000000000001111111111111111111
11000000000000000000000001111111000000000000000000000002222222222221111111
11000000000000000000000001111111000000000000000000000002222222222221111111
11000000000000000000000001111111000000000000000000000002222222222221111111
11000000000000000000010001111111000000000000000000000002222222222221111111
11000000000000000000100001110111000000000000000000000002222222222221111111
11000000000000000000000001110111000000000000000000000001111111111111111111
11000000000000000000000000000000000000000000000000000001111111111111111111
11000000000000000000000000000000000000000000000000000001111111111111111111
11000000000000000000000000000000000000000000000000000001111111111111111111
11000000000000000000000000000000000000000000000000000001111111111111111111
11000000000000000000000000000000000000000000000000000001111111111111111111
11000000000000000000000000000000000000000000000000000001111111111111111111
11000000000000000000000000000000000000000000000000000001111111111111111111
11000000000000000000000000000000000000000000000000000001111111111111111111
11000000000000000000000000000000000000000000000000000001111111111111111111
11000000000000000000000000000000000000000000000000000001111111111111111111
11000000000000000000000000000000000000000000000000000001111111111111111111
11111111111111111111111111111111111111111111111111111111111111111111111111
11111111111111111111111111111111111111111111111111111111111111111111111111
11111111111111111111111111111111111111111111111111111111111111111111111111
