-68
47
-41
48
11111111111111111111111111111111111111111111111111111111111111111111111111111111111111111111111111111111111111111111
11111111111111111111111111111111111111111111111111111111111111111111111111111111111111111111111111111111111111111111
11111111111111111111111111111111111111111111111111111111111111111111111111111111111111111111111111111111111111111111
11111111111111111111111111111111111111111111111111111111111111111111111111111111111111111111111111111111111111111111
11111111111111111111111111111111111111111111111111111111111111111111111111111111111111111111111111111111111111111111
11111111111111111111111111111111111111111111111111111111111111111111111111111111111111111111111111111111111111111111
11111111111111111111111111111111111111111111111111111111111111111111111111111111111111111111111111111111111111111111
11111111111111111111111111111111111111111111111111111111111111111111111111111111111111111111111111111111111111111111
11111111111111111111111111111111111111111111111111111111111111111111111111111111111111111111111111111111111111111111
11111111111111111111111111111111111111111111111111111111111111111111111111111111111111111111111111111111111111111111
11111111100000000000000000000000000000000000000000000000000000000000000000000000000000000000000000000000000001111111
11111111100000000000000000000000000000000000000000000000000000000000000000000000000000000000000000000000000001111111
11111111100000000000000000000000000000000000000000000000000000000000000000000000000000000000000000000000000001111111
11111111100000000000000000000000000000000000000000000000000000000000000000000000000000000000000000000000000001111111
11111111100000000000000000000000000000000000000000000000000000000000000000000000000000000000000000000000000001111111
11111111100000000000000000000000000000000000000000000000000000000000000000000000000000000000000000000000000001111111
11111111100000000000000000000000000000000000000000000000000000000000000000000000000000000000000000000000000001111111
11111111100000000000000000000000000000000000000000000000000000000000000000000000000000000000000000000000000001111111
11111111100000000000000000000000000000000000000000000000000000000000000000000000000000000000000000000000000001111111
11111111100000000000000000000000000000000000000000000000000000000000000000000000000000000000000000000000000001111111
11111111100000000000000000000000000000000000000000000000000000000000000000000000000000000000000000000000000001111111
11111111100000000000000000000000000000000000000000000000000000000000000000000000000000000000000000000000000001111111
11111111100000000000000000000000000000000000000000000000000000000000000000000000000000000000000000000000000001111111
11111111100000000000000000000000000000000000000000000000000000000000000000000000000000000000000000000000000001111111
11111111100000000000000000000000000000000000000000000000000000000000000000000000000000000000000000000000000001111111
11111111100000000000000000000000000000000000000000000000000000000000000000000000000000000000000000000000000001111111
11111111100000000000000000000000000000000000000000000000000000000000000000000000000000000000000000000000000001111111
11111111100000000000000000000000000000000000000000000000000000000000000000000000000000000000000000000000000001111111
11111111100000000000000000000000000000000000000000000000000000000000000000000000000000000000000000000000000001111111
11111111100000000000000000000000000000000000000000000000000000000000000000000000000000000000000000000000000001111111
11111111100000000000000000000000000000000000000000000000000000000000000000000000000000000000000000000000000001111111
11111111100000000000000000000000000000000000000000000000000000000000000000000000000000000000000000000000000001111111
11111111100000000000000000000000000000000000000000000000000000000000000000000000000000000000000000000000000001111111
11111111100000000000000000000000000000000000000000000000000000000000000000000000000000000000000000000000000001111111
11111111100000000000000000000000000000000000000000000000000000000000000000000000000000000000000000000000000001111111
11111111100000000000000000000000000000000000000000000000000000000000000000000000000000000000000000000000000001111111
11111111100000000000000000000000000000000000000000000000000000000000000000000000000000000000000000000000000001111111
11111111100000000000000000000000000000000000000000000000000000000000000000000000000000000000000000000000000001111111
11111111100000000000000000000000000000000000000000000000000000000000000000000000000000000000000000000000000001111111
11111111100000000000000000000000000000000000000000000000000000000000000000000000000000000000000000000000000001111111
11111111100000000000000000000000000000000000000000000000000000000000000000000000000000000000000000000000000001111111
11111111100000000000000000000000000000000000000000000000000000000000000000000000000000000000000000000000000001111111
11111111100000000000000000000000000000000000000000000000000000000000000000000000000000000000000000000000000001111111
11111111100000000000000000000000000000000000000000000000000000000000000000000000000000000000000000000000000001111111
11111111100000000000000000000000000000000000000000000000000000000000000000000000000000000000000000000000000001111111
11111111100000000000000000000000000000000000000000000000000000000000011111110000000000000000000000000000000001111111
11111111100000000000000000000000000000000000000000000000000000000000011111110000000000000000000000000000000001111111
11111111100000000000000000000000000000000000000000000000000000000000011111110000000000000000000000000000000001111111
11111111100000000000000000000000000000000000000000000000000000000000011111110000000000000000000000000000000001111111
11111111100000000000000000000000000000000000000000000000000000000100011111110000000000000000000000000000000001111111
11111111100000000000000000000000000000000000000000000000000000001000011101110000000000000000000000000000000001111111
11111111100000000000000000000000000000000000000000000000000000000000011101110000000000000000000000000000000001111111
11111111100000000000000000000000000000000000000000000000000000000000000000000000000000000000000000000000000001111111
11111111100000000000000000000000000000000000000000000000000000000000000000000000000000000000000000000000000001111111
11111111100000000000000000000000000000000000000000000000000000000000000000000000000000000000000000000000000001111111
11111111100000000000000000000000000000000000000000000000000000000000000000000000000000000000000000000000000001111111
11111111100000000000000000000000000000000000000000000000000000000000000000000000000000000000000000000000000001111111
11111111100000000000000000000000000000000000000000000000000000000000000000000000000000000000000000000000000001111111
11111111100000000000000000000000000000000000000000000000000000000000000000000000000000000000000000000000000001111111
11111111100000000000000000000000000000000000000000000000000000000000000000000000000000000000000000000000000001111111
11111111100000000000000000000000000000000000000000000000000000000000000000000000000000000000000000000000000001111111
11111111100000000000000000000000000000000000000000000000000000000000000000000000000000000000000000000000000001111111
11111111100000000000000000000000000000000000000000000000000000000000000000000000000000000000000000000000000001111111
11111111100000000000000000000000000000000000000000000000000000000000000000000000000000000000000000000000000001111111
11111111100000000000000000000000000000000000000000000000000000000000000000000000000000000000000000000000000001111111
11111111100000000000000000000000000000000000000000000000000000000000000000000000000000000000000000000000000001111111
11111111100000000000000000000000000000000000000000000000000000000000000000000000000000000000000000000000000001111111
11111111100000000000000000000000000000000000000000000000000000000000000000000000000000000000000000000000000001111111
11111111100000000000000000000000000000000000000000000000000000000000000000000000000000000000000000000000000001111111
11111111100000000000000000000000000000000000000000000000000000000000000000000000000000000000000000000000000001111111
11111111100000000000000000000000000000000000000000000000000000000000000000000000000000000000000000000000000001111111
11111111100000000000000000000000000000000000000000000000000000000000000000000000000000000000000000000000000001111111
11111111100000000000000000000000000000000000000000000000000000000000000000000000000000000000000000000000000001111111
11111111100000000000000000000000000000000000000000000000000000000000000000000000000000000000000000000000000001111111
11111111100000000000000000000000000000000000000000000000000000000000000000000000000000000000000000000000000001111111
11111111100000000000000000000000000000000000000000000000000000000000000000000000000000000000000000000000000001111111
11111111100000000000000000000000000000000000000000000000000000000000000000000000000000000000000000000000000001111111
11111111100000000000000000000000000000000000000000000000000000000000000000000000000000000000000000000000000001111111
11111111100000000000000000000000000000000000000000000000000000000000000000000000000000000000000000000000000001111111
11111111100000000000000000000000000000000000000000000000000000000000000000000000000000000000000000000000000001111111
11111111100000000000000000000000000000000000000000000000000000000000000000000000000000000000000000000000000001111111
11111111100000000000000000000000000000000000000000000000000000000000000000000000000000000000000000000000000001111111
11111111100000000000000000000000000000000000000000000000000000000000000000000000000000000000000000000000000001111111
11111111111111111111111111111111111111111111111111111111111111111111111111111111111111111111111111111111111111111111
11111111111111111111111111111111111111111111111111111111111111111111111111111111111111111111111111111111111111111111
11111111111111111111111111111111111111111111111111111111111111111111111111111111111111111111111111111111111111111111
11111111111111111111111111111111111111111111111111111111111111111111111111111111111111111111111111111111111111111111
11111111111111111111111111111111111111111111111111111111111111111111111111111111111111111111111111111111111111111111
11111111111111111111111111111111111111111111111111111111111111111111111111111111111111111111111111111111111111111111
11111111111111111111111111111111111111111111111111111111111111111111111111111111111111111111111111111111111111111111
